* * * * * - - - - - - - - - - - - - - - - - - - * * * * * 
* * * * * b - - - - - - - - - - - - - - - - - b * * * * * 
* * * * * - * * * * * * * * * * * * * * * * * * * * * * * 
* * * * * - * * - - - - * * * * * - - - - * * - * * * * * 
* * * * * - * * - y y - * * * * * - y y - * * - * * * * * 
* * * * * - * * - - - - * * * * * - - - - * * - * * * * * 
* * * * * - * * * * * * - - b - - * * * * * * - * * * * * 
* * * * * - * * * * * * - * * * - * * * * * * - * * * * * 
@ - - - - - * * * * * * - * * * - * * * * * * p - - - - t 
* * * * * - * * * * * * - * * * - * * * * * * - * * * * * 
* * * * * - - - - - - - - * * * - - - - - - - - * * * * * 
* * * * * * * * * * * * * * * * * * * * * * * * * * * * * 
* * * * * * * * * * * * * * * * * * * * * * * * * * * * * 