- - - - - b - - - - - * * * * * * * * *
@ b - - - - - - - - - - - - * * * * * *
- b - - - - - - - - - * - * * * * * * *
- - - - - - - - - * * * - - - * * * * *
- - - - - - * - - * * * * - - - * * * *
- - - - - - * * * * * * * - - - * - - *
- - * * * * * * * * * - - - - * * - - *
- - * * * * * * * * - - - - - * * - - t
- - * * * * * * * * - - * * - * - - * *
- - * * * * * * * * * - * * - - - * * *