* * * * * * * * * * * * - - - - - - - t
* - - * * * * * * * * * b - - - b - - -
* - - * * * * * * * - - - - - - - - - -
- - - - - * * * - * - - - - - - - - - -
- - - - - - - * - - - - - - - - - - - -
- - - - - - - - - - - - - - - - - - - -
- - - - - - - - - - - - - - - - - - - *
- - - - - - - - - - * - - b - - - - - -
- - - - - * * * * - - - - - - - - - - -
@ - - - * * * * * - - - - - * - - - - -