* * - - - - - - - - * - * * * * * * * *
- - - - - - - - - - - - * * * * * * * *
- - - - - - - - - - * - * * * * * * * *
- - - - - - - - - - - - * * * * * * * *
- - - - - - - - - - - - * * * * * * * *
- b - - - - - - - - - - - * * * - * * *
- - - - - - b - - - - - - * * - - * * *
@ - b - - - - - - - - - - - - - - * * t
- - - - - - - - - - - - - - - - - - - -
- - - - - * - - - - - - - - - - - - - -