* * * - - - - - - * * * - - - * * * * *
* * * - - b - - - - - - - - - * * * * *
* * * - - - - * * * * - - - - - - - - -
- - * - - - - b * * * * - - - - - - - -
- - * - - - - - * * * * * * * * - - - -
@ - - - - - - - - * * * * * * * - * * *
- - - - - - - - - * * * * * * * - * * *
* * * * - - - * - * * * * * * - - - - *
* * * * * * * * * * * * * * * - - - - -
* * * * * * * * * * * * * * * - - - * t