- - - - - - - - - - - - - - - * * * * *
- - - - - - - - - - - - - - - - * * * *
- - - - - - - - - - - - - - - - * * * *
- - b - - - - - - - * * - - - - * * * *
- - - - - - - - - - * * * * - - * * * *
- - - - - - b - - - - * * * - - * * * *
- - - - - - - - - - - - - * - * * * * *
@ - b - - - - * * - - - - - - * * * - *
- - - - - - - * * * * - - - - * * - - t
* * - - - - - * * * * - - * - - - - - -