* * * * * * * * * - - - * - - * - - - *
* * * * * * * * * - - - - - - * - - - t
* * * * * * * * * * * * - - - * * - - -
- - * * * * * * * * * * * - - - - - - -
@ - - - * - * - - * - - - - - - - - - -
- b - - - - - - - - - - - - - - - - - -
- - - - - - - - - - - - - - - * - - - -
- - - - - - - - - - * - - - - - * * * -
- - - - - - - - - - - - - - - - - - - -
- - - b - - - * - - b - - - - - - - - -